###################
##    ##          #
#  0              #
#      0     yyyyy#
#    x            #
###################