###################
##    ##          #
#  0              #
#      0     y y y#
#    x            #
###################