########
#   #  #
# #y0 0#
#   0  #
#####y #
  #   x#
  #   y#
  ######