###################
##    ##          #
#  0        y     #
#      0       y ##
#    x     ##     #
###################