########
## x ###
## y   #
#y 0y0 #
##0# ###
##   ###
########