  #####
 ##   ##
 #  0yy##
##0 #y0y#
#   #yyy#
# 0###0 #
#  0 0 ##
##x    #
 #######