########
##  ####
#yy0  y#
# #0 0 #
#x  #  #
#####  #
########