#########
###x ####
###  ####
### y####
#  y0   #
# 0yy 0 #
### 0####
###  ####
#########