########
#      #
# #0   #
# 0 x#y#
##0#y  #
 #    y#
 #######