########
###y####
### ####
###0 0y#
#y 0x###
####0###
####y###
########