#########
#x      ##
# 0#0#   #
#y0y  00 #
#yyy###  #
##### ####