########
#   ####
# 00   #
# y#y  #
#  ## ##
#  ##0##
# x  y##
########