  ####
###  ##
#   0 #
# #y#x#
# #0 y#
#  y0 #
##   ##
 #####