######
#x  y####
#  000  #
#y##y##y#
#   0   #
## #y0  #
 #   ####
 ##### 