########
# y  ###
# y# ###
# x00  #
# 0y   #
########