######################
##    ##          ####
#  0               y #  
#           0        #
#    x              ##	
###     ##     y   ######
#########################