#########
#  x#####
# 00#####
# 0 ###y#
### ###y#
##     y#
#    #  #
#    ####
#########