        #######
  #######  yyy#
  #       yyyy#
### # ### yyyy#
#   # ###yyyyy#
# ###   #yyyyy#
# #  0 0#######
# # 000   #   ###
# # 0 0 0 # x   ####
# # 0 000   # 0    #
# #   0  ##### ### #
# ### # 0#   0   # #
#   #    # 0 0 0 # #
### #### ## ### ## #
  #    # ##  ## #  #
  ####       ## # ##
     ###  ### 0 # #
       #### #  0  #
            #   ###
            #####  