############
###	 ###
#yx0	 ###
### 0y	####
#y##0	 ###
# # y	 ###
#0  00   y##
#   y     ##
############