###############
# x        ####
# 0        0 ##
##0####   y# ##
#        yyy ##
# 0   0  #y ###
#######     ###
########   ####
###############