###########
#   #######
# 0x0     #
##y##     #
# y ##0####
# y       #
#  #      #
###########