#########
#####  ##
#   #  ##
# 0 x  ##
## ###y##
##00  y #
##    y #
######  #
#########