###################
###              ##
##     ##### #  0##
#          # 0  0 #
#  yyy     ##0  0 #
#  y#y     #    0 #
#  yyy     # 0x 0 #
#        ###     ##
###################