########
#### x##
####   #
#y #00 #
#     ##
#y  0###
##y  ###
########