###############
###     #y ####
###   0 yyy####
##   0  ##y####
## ####0 ######
#   0     0  ##
#	#    ##
###########x ##
###############